SOOOWWWWOOOOWOW
OWWOWOOOOWWWWOW
OOWWWOWWOWWOOOO
WOOOOOWWOOWOWWO
OWWWWOOOOWOOOOO
OOOOWOWOWWOWWWO
WOWOOOOOWOOWOWO
WOWWWWWWOOOOOWO
WOWOOOOOOWWWWWO
OOOOWWWWOWWOOOO
OWOOOWOWWWWOWWO
OWOWOWOOOOOOWWO
OWOWOWOWWWWWWWO
WOOWWWOWWOOOWWW
WWOOOWOOOOWOTBF